PPPPPPPPPP
P   PPP SP
P P PPT  P
PEPPEPPPPP
P OPIW OPP
PEPPEPPPPP
P P  P P P
P      PPP
PT PP E OP
PPPPPPPPPP
