PPPPPPPPPP
P        S
P        P
P        P
P        P
P        P
P        P
P        P
P        P
PPPPPIPPPP
