PPPPPPPPPP
P   P   ES
P P     PP
P PP P P P
PE       P
PPP P PP P
P        P
P P POP PP
P     E  P
PPPPPIPPPP
